NO textures/N2.xpm
SO textures/S2.xpm
WE textures/W2.xpm
EA textures/E2.xpm

F 220,100,0
C 225,30,0

  W     1111111111111111111111111
        1000000000110000000000001
        1011000001110000000000000
        10010000000000000S0000001
111111111011000001110000000000001
100000000011000001110111111111110
11110111111111011100000010001
11110111111111011101010010001
110000E0110101011100000010001
10000000000000001100000010001
10000000000000001101010010001
11000001110101011111011110N0111
01110111 1110101 101111010001
11110111 1111111 111000000111LOL