F 0,254,0


EA textures/E2.xpm


WE textures/W2.xpm
SO textures/S2.xpm
C 0,255,255

NO textures/N2.xpm



        1111111111111111111111111
        1000000000010000000000001
        1011000001210000000000001
        1001000002020000000000001
111111111011000001210000000000001
100000000011000001010111112111111
11110111111111011100000010001
11110111111111011101010010001
11000000110101011100000010001
10000000000000001100000010001
10000000000000001101010010001
11000001110101011111011110N0111
11110111 1110101 101111010001
11111111 1111111 111111111111
