NO textures/N_wall.xpm
SO textures/S_wall.xpm
WE textures/W_wall.xpm
EA textures/E_wall.xpm

F 0,254,0
C 0,255,255

        1111111111111111111111111
        1000000000110000000000001
        1011000001110000000000001
        1001000000200000000000001
111111111011000001110000000000001
100000000011000001110111112111111
11110111111111011100000010001
11110111111111011101010010001    1111111
11000000110101011100000010001    1001001
10000000000000001100000010001    1010101
10000000000000001101010010001    1001001
11000001110101011111011110N0111  1111111
11110111 1110101 101111010001
11111111 1111111 111111111111
